#######
#     B
# # # #
# # # #
# # # #
#     #
# ### #
      #
A######