##############
# ####     # #
# #      #   #
# # ##B# # ###
# # #### #   #
# #   ###### #
# # # ####   #
A   #      ###
##############